{
  "id": 14,
  "layout": [
    "WWWWWWWWWWWWWWWWWWWWWWWWWWWWWWWWWWWWWWWWWWWWWWWWWWW",
    "WW________WW____W___W___________W_____W_____W___W_W",
    "WWWWW_WWW_WWW_W_W_W_W_W_W_WWWWW_W_W_W_W_WWW_W_W_W_W",
    "W___W_W___W___W___W___W_W_WW__W___W_W___W_W_W_W___W",
    "W_W_W_W_WWW_WWWWWWWWWWW_W_WWW_WWWWW_WWWWW_W_W_WWW_W",
    "W_W___W_WW______W___W___W___W_W___W_W___W___W_W___W",
    "W_WWWWW_WWW_WWW_W_WWW_WWWWW_W_W_W_W_W_WWW_WWW_W_WWW",
    "W___WWW___W_W_W_W_____WW______W_W_W_W_____W___W_WWW",
    "WWW_W_WWW_W_W_W_WWW_WWWWWWWWWWW_W_W_WWW_WWW_WWW_W_W",
    "W___W_____W___W___W___W_________W_W___W_____W_W_W_W",
    "W_WWW_WWWWWWWWW_W_WWW_W_WWWWWWWWW_WWW_WWWWWWW_W_W_W",
    "W___W_WW______WWW___W_W_W______WW___W_W_______W___W",
    "W_W_W_WWW_WWW_WWWWW_W_W_W_WWWWWWWWW_W_W_WWWWW_WWW_W",
    "W_W_W_____W_W_____W_W_W_W_________W___W_W_____W___W",
    "WWW_WWWWWWW_WWWWW_W_W_W_W_WWWWW_WWWWWWW_W_WWWWW_WWW",
    "_SW_W_______W___W___W___W_W___W___W___W_W_____W__EW",
    "W_W_W_WWWWWWW_W_WWWWWWWWW_W_W_WWW_W_W_W_WWWWW_WWW_W",
    "W_W_W_W_____W_W________WW___W_WWW___W_W_W___W__WW_W",
    "W_W_W_W_WWW_W_WWWWW_WWWWWWWWW_W_WWWWW_W_W___W_WWW_W",
    "W_W_W___WWW___W_W___W_____W___W_____W___W_W_W___W_W",
    "W_W_W_WWW_WWWWW_W_WWW_WWW_W_WWWWW_W_WWWWW_W_WWW_W_W",
    "W_W_W_____W_____W___W_W___W_W_____W_W_____W_W___W_W",
    "W_W_WWWWW_W_WWWWWWW_W_W_WWW_W_WWWWW_WWW_W_WWW_WWW_W",
    "W___W___W_W_____W___W_W_____W_____W_____W_W___W___W",
    "WWW_WWW_W_WW_WW_W_WWW_WWWWWWW_WWW_WWWWWWWWW_WWW_WWW",
    "W_______W_____W_W___W___W_____W___W___W___W_W___WWW",
    "WWW_WWWWWWWWW_W_WWW_WWW_W_WWWWW_W_W___W_W_W_W_WWW_W",
    "W___W___W_____W___W___W_WWW_____W_W_W___W___W___W_W",
    "W_WWW_W_W_WWWWW_W_WWW_W_WWW_WWWWW_W_WWWWWWWWWWW_W_W",
    "W_____W_________W___W_______WW____W_______________W",
    "WWWWWWWWWWWWWWWWWWWWWWWWWWWWWWWWWWWWWWWWWWWWWWWWWWW"
  ]
}