{
  "id": 12,
  "layout": [
    "WWWWWWWWWWWWWWWWWWWWWWWWWWW",
    "WWWWWWWWWWWWWWWWWWWWWWWWWWW",
    "WWWWWWWWWWWWWWWWWWWWWWWWWWW",
    "W_________WWW____WW____1@WW",
    "W_WWWWW_WWWWW_WW_WW_WW_WWWW",
    "W_WWWWW_WWWWW_WW_WW_WW_WWWW",
    "W____WW_______WW____WW____W",
    "WWWW_WWWWWWWWWWWWWWWWWWWW_W",
    "WWWW_WWWWWWWWWWWWWWWWWWWW_W",
    "WWWW___________________WW_W",
    "W_WWWWWWWW_WWpWWWWWWWWWWW_W",
    "W_WWWWWWWW_WWpWWWWWWWWWWW_W",
    "W_______WW_WW____WW____WW_W",
    "WWWW_WWWWW_WW_WW_WW_WW_WW_W",
    "WWWW_WWWWW_WW_WW_WW_WW_WW2W",
    "_SWW_______WW_WW_WW_WW_W_EW",
    "W_WW_WWWWWWWW_WW_WW_WW_WWWW",
    "W_WW_WWWWWWWW_WW_WW_WW_WWcW",
    "W_WW____TTWWW_WW_WW_WW____W",
    "W_WWWWWWWWWWW_WW_WW_WWWWWWW",
    "W_WWWWWWWWWWW_WW_WW_WWWWWWW",
    "W__________WW_WW_WW_______W",
    "WWWWWWWWWW_WW_WW_WWWWWWWW_W",
    "WWWWWWWWWW_WW_WW_WWWWWWWW_W",
    "W!WW____WW_WW_WW__________W",
    "W_WW_WW_WW_WW_WWWWWWWWWWW_W",
    "W_WW_WW_WW_WW_WWWWWWWWWWW_W",
    "W____WW_______WW__________W",
    "WWWWWWWWWWWWWWWWWWWWWWWWWWW",
    "WWWWWWWWWWWWWWWWWWWWWWWWWWW",
    "WWWWWWWWWWWWWWWWWWWWWWWWWWW"
  ]
}