{
  "id": 13,
  "layout": [
    "WWWWWWWWWWWWWWWWWWWWWWWWWWWWWWWWWWWWWWWWWWWWWWWWWWW",
    "W________WW_______W_________W___W_____________Wc__W",
    "W_WWWWW_WWW_WWWWW_W_WWW_WWW_W_W_WWWWW_WWWWWWW_WWW_W",
    "W___W_W_W___W___W___W___WWW_W_W_____W_____W_W_____W",
    "WWW_W_W_W_WWWWW_WWWWW_WWW_W_W_WWWWW_W_WWW_W_WWWWW_W",
    "W@W_W_W___W_______W___WW__W___W___W_W___W_W_______W",
    "WpW_W_WWWWWWW_WWW_W_WWWWW_WWWWW_W_W_WWW_W_WWWWWWWWW",
    "W___W_________WW__W_W___________WWW_W___W_________W",
    "W_WWW_WWWWWWWWWWWWW_W_WWWWW_WWWWWWW_W_WWWWWWWWWWW_W",
    "W_____W_____W_______W___WWW_W_______W_W_______W___W",
    "WWWWW_W_WWW_W_WWWWWWW_W_W_W_W_WWWWWWW_WWWWWWW_W_WWW",
    "W_____W___W___W___W___W_W___W_W___W___W_______W___W",
    "WWWWWWWWW_WWWWW_W_W_WWW_WWW_W_W_W_W_WWW_WWW_WWWWW_W",
    "W___W___W___WWW_W_____W___W_W_W_W___W___WWW_W_____W",
    "W_W_W_W_WWW_W_W_WWWWWGWWW_W_W_WWW_WWW_WWW_W_W_WWWWW",
    "_SW_W_W_____W___W_W____GW_WWW___W_WW__W___W_W_B21EW",
    "WWW_W_WWWWWWW_WWW_WGWWW_W_WWWWW_W_WWW_W_W_W_W_WWW1W",
    "W___W_____W___W___W___W_W_W_____W_____WWW_____W__2W",
    "W_WWWWW_W_W_WWW_W_WWW_W_W_W_WWWWWWW_WWWWWWWWW_W_WWW",
    "W_____W_W_W_____W_W_W_W_W_W_______WWW_____W_______W",
    "WWWWW_WWW_WWWWWWW_W_W_W_W_WWWWWWW_WWW_WWW_WWWWWWW_W",
    "W__WW___W_____W_____W_____W___W___W___W_________W_W",
    "W_WWWWW_W_WWW_WWWWWWW_WWW_W_W_W_WWW_WWWWWWWWWWW_W_W",
    "W_W_____W_WWW_W_______WW____WWW_W___W___WW____W___W",
    "W_W_WWWWW_W_W_W_WWWWWWWWWWWWWWW_W_WWW_W_WWW_WWWWW_W",
    "W___WW______W_W___________W_____W_____W___W_______W",
    "W_WWWWW_WWWWW_W_WWWWWWWWW_W_WWWWW_WWWWWWW_WWWWW_WWW",
    "W_____WWW_____W_______W___W_____W___W___W_____W___W",
    "WWWWW_WWW_WWWWWWWWWWW_W_WWWWWWW_WWWWW_W_WWWWW_WWWpW",
    "W_________WW__________W_______________W_______WW!pW",
    "WWWWWWWWWWWWWWWWWWWWWWWWWWWWWWWWWWWWWWWWWWWWWWWWWWW"
  ]
}